back pain not otherwise specified back pain not otherwise specified dry mouth unspecified cardiac arrhythmia unspecified	back pain not otherwise specified back pain not otherwise specified dry mouth unspecified cardiac with me unspecified
chest pain unspecified chest pain unspecified nausea other chest pain shortness of breath asthenia not otherwise specified shortness of breath	elsepain unspecified chest pain unspecified nausea other chest pain shortness of breath asthenia not otherwise specified shortness of breath
change in mental status not otherwise specified change in mental status not otherwise specified hematuria asthenia not otherwise specified asthenia not otherwise specified unspecified infectious disease	change in mental status not otherwise specified change in mental needs not otherwise specified em thus famia not otherwise specified asthen not otherwise specified unspecified infectious deceased
generalized pain not otherwise specified injury unspecified nausea acute pain due to trauma	generalized pain not otherwise specified injury unspecified nausea acute pain due to trauma
abdominal tenderness not otherwise specified generalized abdominal pain generalized abdominal pain urinary tract infection site not specified vomiting of pregnancy unspecified	abdominal tenderness not otherwise specified generalized abdominal pain generalized abdominal pain urinary tract infection site not specified vomiting of regue unspecified
unspecified atrial fibrillation cardiac arrhythmia unspecified cervicalgia unspecified injury of neck	unspecified atrial fabrillation cardiac arrhythmia unspecified unspecified injury of neck
hallucinations unspecified other symptoms and signs involving emotional state generalized idiopathic epilepsy and epileptic syndromes fit not otherwise specified	hallucinations unspecified other symptomspes involving emotional status generalized idiopathic epilepsy and epileptic syndromes fit not otherwise specified
suicidal ideations change in mental status not otherwise specified violent behavior anxiety not otherwise specified poisoning by unspecified drugs medicaments and biological substances undetermined	free cyal ideations change in mental status not otherwise specified violent haver anxiety not otherwise specified isn't unspecifits medicaments and biological substances undermiment
adult hyaline membrane disease opioid related disorders other general symptoms and signs other psychoactive substance related disorders	adult hyaline membrane disease opioid related disorders other general symptoms and signs other psychoactive substance related disorders
fever with chills asthenia not otherwise specified unspecified injury of unspecified thigh unspecified injury of lower leg	fever with choose thus fem not otherwise specified unspecified injury of unspecified unspecified injury of lowck
adult hyaline membrane disease sepsis unspecified organism sepsis unspecified organism dyspnea unspecified pneumonia unspecified organism	adult hyaline membrane disease sepsis unspecified organism sepsis unspecified organism disnear unspecified iniot organism
suicidal ideations other symptoms and signs involving emotional state nausea major depression not otherwise specified light headedness alcohol use unspecified	suicidal ideations other symptoms and signs involving emotional status nausea major depression not otherwise specified light headedness hypothers unspecified
other general symptoms and signs toxic effect of carbon monoxide nausea with vomiting unspecified nausea	other general symptoms and signs obstetric of carbon monoxide nausea with vomiting unspecified nausea
nausea other specified diabetes mellitus with hyperglycemia chronic debility vomiting unspecified generalized pain not otherwise specified chronic debility	nausea other specified diabetes mellitus with hyperglycemia chronic debility vomiting unspecified generalized pain not otherwise specified chronic debility
unspecified injury of ankle unspecified injury of lower leg unspecified injury of abdomen unspecified injury of thigh unspecified injury of head unspecified injury of hip unspecified injury of head	unspecified injury of ankle unspecified injury of lower lect unspecified injury of abdominal unspecified injury of thighs unspecified injury of head unspecified injury of high unspecified injury of head
apnea not otherwise specified cardiorespiratory failure cardiorespiratory failure cardiac arrhythmia unspecified	pain not otherwise specified cardiorespiratory fit cardiors arrhythmia unspecified
apnea not otherwise specified cardiac arrest cause unspecified cardiac arrest cause unspecified presence of cardiac pacemaker unconsciousness not otherwise specified	back near not otherwise specified cardiac cause unspecified cardiac arrest cause unspecified presence of cardiac pacemake unconsciousness not otherwise specified
unspecified injury of unspecified eye and orbit unspecified injury of lower leg irritability and anger unspecified injury of ankle unspecified injury of foot unspecified injury of head unspecified injury of head	unspecified injury of unspecified eye and orbit unspecified injury of lower lect irritability and angle unspecified injury of ankle unspecified injury of foot unspecified injury of head unspecified injury of head
asthenia not otherwise specified adult hyaline membrane disease tachypnea not elsewhere classified adult hyaline membrane disease dyspnea unspecified fatigue not otherwise specified	asthenia not otherwise specified adult isabel disease not nee not classified adult hyaline membrane disease disease unspecified deities specified
hyperglycemia unspecified generalized pain not otherwise specified pain in throat other specified diabetes mellitus with hyperglycemia	hyperglycemia unspecified generalized pain not otherwise specified pain in throat other specifi
hemorrhage not otherwise specified unspecified early complication of trauma initial encounter change in mental status not otherwise specified unspecified intracranial injury without loss of consciousness initial encounter nontraumatic intracerebral hemorrhage unspecified	hemorrhage not otherwise specified unspecified early complication of trauma initial encounter tenderstas not otherwise specified unspecified intrainia injury not lucerd consciousness initial counter nonsenct intracer hemorrhage unspecified
other chest pain other chest pain nausea with vomiting unspecified alcohol dependence with withdrawal alcohol dependence with withdrawal unspecified	other chest pain other chest pain nausea with vomiting unspecified back pendence with visual alcohol dependence with withdrawal unspecified
generalized pain not otherwise specified unspecified early complication of trauma initial encounter nausea generalized pain not otherwise specified	generalized pain not otherwise specified unspecified early complication of trauma initial encounter nausea generalized pain not otherwise specified
other seizures alcohol use unspecified nausea adult hyaline membrane disease	other seizures alcohol use unspecified influte hyaline membrane disease
generalized abdominal pain generalized abdominal pain headache hyperglycemia unspecified other specified diabetes mellitus with hyperglycemia	generalized abdominal pain generalized abdominal pain leg hyperglycemia unspecified other specified diabetes meditats with hyperglycemia
alcohol use unspecified with other alcohol induced disorder alcohol use unspecified encounter for adult health check up not otherwise specified foreign body in respiratory tract part unspecified	alcohol use unspecified with other alcohol induced disorder back holes unspecified injury adult health check up not otherwise specified floty in respiratory tract part unspecified
pain in lower limb not otherwise specified unspecified injury of forearm pain in unspecified forearm unspecified injury of unspecified ankle	pain in lower limb not otherwise specified unspecified injury of forearm pain in unspecified forearm unspecified injury of unspecified ankle
back pain not otherwise specified back pain not otherwise specified other general symptoms and signs wheezing unspecified asthma with acute exacerbation	back pain not otherwise specified back pain not otherwise specified other general symptoms and signs wheezing unspecified asthma with acute estation
change in mental status not otherwise specified cerebral infarction unspecified disorientation unspecified facial droop unspecified lack of coordination change in mental status not otherwise specified	change in mental status not otherwise specified cerebral infarction unspecified disorientation unspecified facial due unspecified lack of quatenation change in mental status not otherwise specified
disorientation unspecified urinary tract infection site not specified fever with chills urinary tract infection site not specified asthenia not otherwise specified change in mental status not otherwise specified	disorientation unspecified urinary tracks infection site not specified fever with chills urinary tract infection site not specified asthenia not otherwise specified change mental status not otherwise specified
eructation change in mental status not otherwise specified nausea with vomiting unspecified change in mental status not otherwise specified vomiting	eructation change in mental status not otherwise specified nausea with vomiting unspecified change mental status not otherwise specified vomiting
severe abdominal pain generalized with abdominal rigidity severe abdominal pain generalized with abdominal rigidity constipation unspecified intestinal obstruction not otherwise specified	severe abdominal pain generalized with abdominal rigidity severe abdominal pain generalized with abdominal rigidity constipation unspecified intestinal obstruction not otherwise specified
asthenia not otherwise specified chronic debility shortness of breath cardiac arrhythmia unspecified	asthenia not otherwise specified chronic debility shortness of breath cardiac arrhythmia unspecified
change in mental status not otherwise specified adult failure to thrive enuresis not otherwise specified encopresis not otherwise specified asthenia not otherwise specified	tent mental status not otherwise specified abotct failure to thrive anxiety not otherwise specified ankle press not otherwise specified thus fannie not otherwise specified
chest pain unspecified other chest pain pain in limb unspecified other specified health status	chest pain unspecified other chest pain pain in limb unspecified other specified health satis
ill defined and unknown cause of mortality cardiac arrest cause unspecified cardiorespiratory failure periodic breathing cyanosis ill defined and unknown cause of mortality	ill defined and unknown cause of mortality cardiac arrest cost unspecified cardiorespiratory favoural periodic breathing seolshy and unknown cause of mortality
change in mental status not otherwise specified hallucinations unspecified visual hallucinations auditory hallucinations injury unspecified	change in mental status not otherwise specified abuse unspecified visual hallucinations order hallucinations injury unspecified
shock unspecified hypotension unspecified hypothermia hypothermia	shock unspecified hypotension unspecified hypoa hypor
acute pain not elsewhere classified acute pain due to trauma headache acute pain not elsewhere classified	acute pain not elsewhere classified acute pain due to trauma ed
pain in unspecified shoulder chest pain unspecified other general symptoms and signs high blood pressure	pain in unspecified shoulder chest pain unspecified other general symptoms and signs high blood pressure
shortness of breath high blood pressure worries respiratory disorder unspecified	shortness of breath hyper voes respiratory disorder unspecified
change in mental status not otherwise specified change in mental status not otherwise specified nausea drowsiness generalized pain not otherwise specified constipation unspecified unspecified abdominal pain	tent moments not otherwise specified change in mental adulties not otherwise specified nausea drowns generalized pain not otherwise specified constipation unspecified unspecified abdominal pain
change in mental status not otherwise specified sepsis unspecified organism senescence asthenia not otherwise specified	change in mental adults not otherwise specified sepsis unspecified organism senescence asthenia not otherwise specified
facial droop change in mental status not otherwise specified other general symptoms and signs headache cerebral infarction unspecified	facial droop change in mental status not otherwise specified other symptoms and signs headacck cerebral infarction unspecified
chest pain unspecified cardiac angina awareness of heart beat other chest pain anxiety not otherwise specified	chest pain unspecified cardiac anginal of heart beat other chest pain anxiety not otherwise specified
influenza due to unidentified influenza virus with other respiratory manifestations influenza due to unidentified influenza virus with other respiratory manifestations congestive heart failure not otherwise specified elevated blood pressure reading without diagnosis of hypertension shortness of breath congestive heart failure not otherwise specified	influenza due to fit inluit with other respiratory manifestation influenza due to identified influenza various with other respiratory manifestation not otherwise specified edema agenose of hypertension shortness breath congestive heart failure not otherwise specified
asthenia not otherwise specified asthenia not otherwise specified facial droop slowness and poor responsiveness cerebral infarction unspecified	asthenia not otherwise specified asthenia not otherwise specified facial drooss and poor responsiveness cerebral infarction unspecified
staggering gait alcohol abuse with intoxication uncomplicated slurred speech alcohol abuse with intoxication unspecified	staggering gait nacous with intoxication unrita alcohol abuse with intoxication unspecified
disorientation unspecified epileptic fits not otherwise specified other general symptoms and signs disorientation unspecified	disorientation unspecified epileptic fits not otherwise specified other general symptoms and signs disorientation unspecified
abdominal and pelvic pain generalized abdominal pain other chest pain cardiac angina	padual and pelvic pain generalized abdominal pain other chest pain cardiac angina
generalized idiopathic epilepsy and epileptic syndromes fit not otherwise specified change in mental status not otherwise specified asthenia not otherwise specified unspecified pre eclampsia	generalized idiopathic epilepsy and epileptic syndromes fit not otherwise specified change in mental status not otherwise specified thus theniga not otherwise specified unspecified pre eclampsi
clammy skin syncope and collapse asthenia not otherwise specified hypotension unspecified	clammy skin syncope and collapse
generalized abdominal pain chest pain unspecified cardiac angina nausea myocardial infarction acute not otherwise specified unspecified abdominal pain	generalized abdominal pain chest pain unspecified cardiac angina not otherwise specified unspecified abdominal pain
unspecified atrial fibrillation cardiac arrhythmia unspecified abdominal tenderness not otherwise specified dyspnea unspecified adult hyaline membrane disease	unspecified atrial bailation cardiac arrhythmia unspecified abdominal tenderness not otherwise specified disnear unspecified adult hyaline membrane disease
change in mental status not otherwise specified poisoning by other synthetic narcotics undetermined vomiting unspecified change in mental status not otherwise specified	sent in mental adulties not otherwise specified pothed by other indic narcotics undetermine vomiting unspecified change in mental adus not otherwise specified
asthenia not otherwise specified major depression not otherwise specified worries anxiety not otherwise specified	asthenia not otherwise specified major depression not otherwise specified worries anxiety not otherwise specified
abdominal tenderness not otherwise specified generalized abdominal pain headache obstetric trauma unspecified	abdominal tenderness not otherwise specified generalized abdominal pain head obstetric trauma unspecified
shortness of breath dyspnea change in mental status not otherwise specified asthenia not otherwise specified unconsciousness not otherwise specified change in mental status not otherwise specified	shortness of breath disneat change in mental status not otherwise specified thus famia not otherwise specified unconsciousness not otherwise specified change in mental athes not otherwise specified
chest pain unspecified chest pain unspecified shortness of breath constipation unspecified shortness of breath	chest pain unspecified chest pain unspecified shortness of breath constipation unspecified shortness of breath
disorientation unspecified other specified diabetes mellitus with hyperglycemia asthenia not otherwise specified hyperglycemia unspecified asthenia not otherwise specified	disorientation unspecified other specified diabetes mellitus with hyperglycemia thus famia not otherwise specified hyperglycemia unspecified asthenia not otherwise specified
clammy skin change in mental status not otherwise specified mental illness not otherwise specified asthenia not otherwise specified disorientation unspecified	clammy skin change in mental status not otherwise specified monois not otherwise specified thystic not otherwise specified disorientation unspecified
diarrhea unspecified generalized abdominal pain left lower quadrant pain nausea with vomiting unspecified right lower quadrant pain vomiting	alread unspecified generalized abdominal pain left lower quadrant pain nausea with vomiting unspecified right lower quadrant pain vomiting
hypotension unspecified chronic debility other general symptoms and signs hypotension unspecified	hypotension unspecified chronic debility other general symptoms and signs hypotension unspecified
chest pain unspecified chest pain unspecified healing pressure ulcer of unspecified site not otherwise specified fatigue not otherwise specified	thus pain unspecified chest pain unspecified heating pressure other of unspecified site not otherwise specified fatigue not otherwise specified
other visual disturbances light headedness light headedness high blood pressure	other visual disturbanc
acute pain due to trauma unspecified injury of head cramp and spasm unspecified injury of elbow	acute pain due to trauma unspecified injury of head cramp and spanial unspecified injury of elbow
diarrhea unspecified sepsis unspecified organism fever with chills other general symptoms and signs fever with chills	diarrhea unspecified sepsis unspecified organism fever with choose other general symptoms and signs severe with chills
tachypnea not elsewhere classified unspecified infectious disease sepsis unspecified organism asthenia not otherwise specified sepsis unspecified organism	tachypnea not elsewhere classified unspecified infectious disease sepsis unspecified organism asthenia not otherwise specified sepsis unspecified organism
allergic shock allergy unspecified hypotension unspecified shortness of breath hypotension unspecified	allergic shock allergy unspecified hypotension unspecified shortness of breath hypotension unspecified
nausea with vomiting unspecified generalized abdominal pain left upper quadrant pain back pain not otherwise specified	nausea with vomiting unspecified generalized abdominal pain left upper quadrant pain back pain not otherwise specified
chest pain unspecified cardiac angina nausea headache light headedness back pain not otherwise specified shortness of breath	feft pain unspecified cardiac anginal back pain not otherwise specified shortness of breath
cardiogenic shock acute edema of lung rapid heart beat hemoptysis tachypnea not elsewhere classified pulmonary edema cardiogenic shock	cardiogenic shock acute edema of lung rapid abuse mostie not elsewhere classified monarry edema cardinal shock
chest pain unspecified unspecified injury of thorax pain in unspecified shoulder unspecified injury of shoulder and upper arm	fespein unspecified unspecified injury of thoraxa unspecified injury of shoulder and upper arm
nausea with vomiting unspecified nausea left lower quadrant pain eructation unspecified abdominal pain	nausea with vomiting unspecified nausea left lower quadrant pain eructation unspecified abdominal pain
asthenia not otherwise specified cerebellar stroke syndrome difficulty in walking not elsewhere classified asthenia not otherwise specified	asthenia not otherwise specified cerebellar stroke syndroe difficulty in walking not elsewhere classified asthen not otherwise specified
other abnormalities of gait and mobility alcohol use unspecified restlessness and agitation other psychoactive substance related disorders	other abanities of gait and mobility alcohol use unspecified restlessness and agitation other syncope substance elated disorders
intestinal hemorrhage not otherwise specified intestinal hemorrhage not otherwise specified wheezing adult hyaline membrane disease	intestinal hemorrhage not otherwise specified intestinal hemorrhage not otherwise specified wheezing adult eyelve membrane disease
dyspnea unspecified adult hyaline membrane disease hemorrhage of anus and rectum intestinal hemorrhage not otherwise specified	dispal unspecified adult hyaline membrane disease demored of underb and rectum intestinal hemorrhage not otherwise specified
hyperglycemia unspecified other specified diabetes mellitus with hyperglycemia hyperventilation painful respiration adult hyaline membrane disease	hyperglycemia unspecified other specified diabetes mellitus with hyperglycemia hypotension painful respiration adult hyaline membrane disease
chest pain unspecified other chest pain asthenia not otherwise specified hyperglycemia unspecified asthenia not otherwise specified	claspe unspecified other chest failure asthenia not otherwise specified hypersymia unspecified asthenia not otherwise specified
nausea with vomiting unspecified dehydration hypotension unspecified vomiting	nausea with vomiting unspecified dehydration hypotension unspecified vomiting
asthenia not otherwise specified other specified diabetes mellitus with hyperglycemia dyspnea unspecified dehydration	asthenia not otherwise specified other specified atris medic with hypercemia disnea unspecified dehydration
other abnormalities of gait and mobility cerebral infarction unspecified asthenia not otherwise specified transient ischaemic attack	other abnormalities of gait and mobility cerebral infarction unspecified thystic not otherwise specified transient ischaemic attack
change in mental status not otherwise specified fit not otherwise specified rapid heart beat high blood pressure hyperglycemia unspecified generalized idiopathic epilepsy and epileptic syndromes high blood pressure	chent in mental status not otherwise specified bit not otherwise specified rapid heart beat hylor hyperglycemia unspecified generalized idiopathic epilepsy and epileptic syndromes high blood pressure
syncope and collapse transient alteration of awareness slurred speech other cerebrovascular disease	syncope and collapse of oranus beach other cerebral lask
chest pain unspecified chest pain unspecified painful respiration pain in limb hand foot fingers and toes respiratory disorder unspecified	chest pain unspecified chest pain unspecified paination pain in limb hint foot fingers and toe respiratory disorder unspecified
shortness of breath shortness of breath anxiety not otherwise specified asthenia not otherwise specified other symptoms and signs involving emotional state	shortness of breath shot of breath analyti not otherwise specified asthenia not otherwise specified other symptoms and signs vohin emotional state
chronic obstructive lung disease not otherwise specified shortness of breath nausea shortness of breath fatigue not otherwise specified	chronic obstruction lung disease not otherwise specified shoulder of breath nausea shot abdominal deck not otherwise specified
hemorrhage not otherwise specified alcohol use unspecified encounter for adult health check up not otherwise specified encounter for adult health check up not otherwise specified	hemorrhage not otherwise specified alcohol use unspecified inhamper adult health check up not otherwise specified encounter for adult health check up not otherwise specified
chest pain unspecified chest pain unspecified generalized abdominal pain shortness of breath strange and inexplicable behavior change in mental status not otherwise specified unspecified abdominal pain	left pain unspecified chest pain unspecified generalized abdominal pain shows of breath strange and inexper hather change in mental status not otherwise specified unspecified abdominal pain
unconsciousness not otherwise specified unconsciousness not otherwise specified other general symptoms and signs generalized idiopathic epilepsy and epileptic syndromes epileptic fits not otherwise specified cerebral infarction unspecified	unconsciousness not otherwise specified unconsciousness not otherwise specified other general symptoms and signs generalized idiopathic epilepsy and epileptic syndromes epileptic fits not otherwise specified cerebral infarction unspecified
facial droop cerebral infarction unspecified other abnormalities of gait and mobility hyperglycemia unspecified hyperglycemia unspecified	fizor due cerebral involve unspecified other abnormalities of gait and mobility hyperglycemia unspecified hyperglycemia unspecified
hemorrhage not otherwise specified generalized abdominal pain hypotension unspecified other general symptoms and signs	hemorrhage not otherwise specified generalized abmoment hypotension unspecified other general symptoms and sices
wheezing adult hyaline membrane disease chronic debility other general symptoms and signs adult hyaline membrane disease asthenia not otherwise specified unspecified infectious disease	easy adult hyaline membrane disease chronic bilities other general hems and signs adult isunes asthenia not otherwise specified unspecified infectious disease
chest pain unspecified accelerated angina shortness of breath anxiety not otherwise specified	chest pain unspecified exiled angina shot uh anxiety not otherwise specified
pain in limb hand foot fingers and toes unspecified injury of shoulder and upper arm back pain not otherwise specified unspecified injury of hip	pain in limb hand foot injury and toes unspecified injury of shoulder and upper arm back pain not otherwise specified unspecified injury of hip
light headedness asthenia not otherwise specified nausea with vomiting unspecified asthenia not otherwise specified vomiting	light headedness thrissped nausea responsive unspecified thus fannie not otherwise specified vomit
adult hyaline membrane disease adult hyaline membrane disease sepsis unspecified organism high blood pressure sepsis unspecified organism	adult hyaline membrane disease adult hyaline membrane disease sepsis unspecified organism hyper sepsis unspecified organism
pain in unspecified hip unspecified injury of hip unspecified abdominal pain unspecified injury of thorax injury unspecified	pain in unspecified hip unspecified injury of hip unspecified abdominal pain unspecified injury of thoraxiny unspecified
dyspnea unspecified chest pain unspecified chest pain unspecified suicidal ideations change in mental status not otherwise specified	dispenetral unspecified chest pain unspecified chest pain unspecified suicidal ideation not otherwise specified